+-+-+-+-+-+-+-+-+-+-+
 *|           |   | |
+ + +-+-+-+-+ + + + +
|         |   | |   |
+-+-+-+-+ + +-+-+-+ +
|   |   | | | |     |
+ + + + +-+ + + +-+-+
| |   |     |   |   |
+ +-+-+-+-+ + +-+ + +
| |       | | |   | |
+ +-+-+-+ + + +-+-+ +
|         |   |     |
+-+ +-+-+-+-+-+ +-+-+
|   |   |     |     |
+ +-+ + + +-+ +-+-+ +
| |   |   |   |     |
+ + +-+-+-+ +-+ + +-+
|   |     |   | |   |
+-+-+ +-+-+ + + +-+ +
|           |   |   ~
+-+-+-+-+-+-+-+-+-+-+